id,name,x,y,Tot.tr,size,% 
1,ABW,2281,11328,13609,0.09,0.017
2,AFG,803,0,803,0.01,0.001
3,AGO,8386,0,8386,0.06,0.011
4,AIA,174,0,174,0.00,0.000
5,ALB,7701,4023,11724,0.08,0.015
6,AND,2155,0,2155,0.01,0.003
7,ANT,795,0,795,0.01,0.001
8,ARE,455292,0,455292,3.03,0.577
9,ARG,65225,63148,128373,0.85,0.163
10,ARM,1583,1730,3313,0.02,0.004
11,ASM,34,0,34,0.00,0.000
12,ATA,47,0,47,0.00,0.000
13,ATG,436,932,1368,0.01,0.002
14,AUS,251158,218197,469355,3.12,0.595
15,AUT,375772,306750,682522,4.54,0.866
16,AZE,8075,20668,28743,0.19,0.036
17,BDI,23,136,159,0.00,0.000
18,BEL,339977,390070,730047,4.86,0.926
19,BEN,30486,4958,35444,0.24,0.045
20,BES,4,0,4,0.00,0.000
21,BFA,359,7724,8083,0.05,0.010
22,BGD,1002,166,1168,0.01,0.001
23,BGR,27541,39710,67251,0.45,0.085
24,BHR,34168,28052,62220,0.41,0.079
25,BHS,1855,10053,11908,0.08,0.015
26,BIH,31533,19120,50653,0.34,0.064
27,BLR,100890,50309,151199,1.01,0.192
28,BLZ,5145,6595,11740,0.08,0.015
29,BMU,466,390,856,0.01,0.001
30,BOL,158312,80015,238327,1.59,0.302
31,BRA,1037121,638042,1675163,11.14,2.125
32,BRB,1182,4908,6090,0.04,0.008
33,BRN,334,413,747,0.00,0.001
34,BTN,24,106,130,0.00,0.000
35,BWA,16308,17155,33463,0.22,0.042
36,CAF,7281,0,7281,0.05,0.009
37,CAN,1149058,728207,1877265,12.49,2.381
38,CCK,20,0,20,0.00,0.000
39,CHE,172601,84190,256791,1.71,0.326
40,CHL,71694,19847,91541,0.61,0.116
41,CHN,6645674,8389143,15034817,100.00,19.068
42,CIV,255607,61834,317441,2.11,0.403
43,CMR,613766,359302,973068,6.47,1.234
44,COD,76695,0,76695,0.51,0.097
45,COG,52724,1399,54123,0.36,0.069
46,COK,160,0,160,0.00,0.000
47,COL,28071,2986,31057,0.21,0.039
48,COM,196,2,198,0.00,0.000
49,CPV,1457,3717,5174,0.03,0.007
50,CRI,6888,3606,10494,0.07,0.013
51,CUB,5975,0,5975,0.04,0.008
52,CUW,1070,0,1070,0.01,0.001
53,CXR,56,0,56,0.00,0.000
54,CYM,199,0,199,0.00,0.000
55,CYP,5705,3073,8778,0.06,0.011
56,CZE,56430,80052,136482,0.91,0.173
57,DEU,1121498,573892,1695390,11.28,2.150
58,DJI,206,0,206,0.00,0.000
59,DMA,89,323,412,0.00,0.001
60,DNK,72939,138727,211666,1.41,0.268
61,DOM,41878,30234,72112,0.48,0.091
62,DZA,14927,175413,190340,1.27,0.241
63,ECU,5490,3582,9072,0.06,0.012
64,EGY,32514,25291,57805,0.38,0.073
65,ERI,144,0,144,0.00,0.000
66,ESP,112079,137452,249531,1.66,0.316
67,EST,194860,279930,474790,3.16,0.602
68,ETH,199,708,907,0.01,0.001
69,EU2,0,2421347,2421347,16.10,3.071
70,FIN,487441,96287,583728,3.88,0.740
71,FJI,4220,5555,9775,0.07,0.012
72,FLK,1873,0,1873,0.01,0.002
73,FRA,391385,331056,722441,4.81,0.916
74,FRO,787,817,1604,0.01,0.002
75,FSM,39,0,39,0.00,0.000
76,GAB,434215,60,434275,2.89,0.551
77,GBR,386016,506954,892970,5.94,1.133
78,GEO,27410,15617,43027,0.29,0.055
79,GHA,104281,357381,461662,3.07,0.586
80,GIB,523,0,523,0.00,0.001
81,GIN,4776,0,4776,0.03,0.006
82,GMB,1527,122,1649,0.01,0.002
83,GNB,929,0,929,0.01,0.001
84,GNQ,6085,0,6085,0.04,0.008
85,GRC,32958,28305,61263,0.41,0.078
86,GRD,76,1,77,0.00,0.000
87,GRL,3705,1975,5680,0.04,0.007
88,GTM,14778,11524,26302,0.17,0.033
89,GUM,221,0,221,0.00,0.000
90,GUY,50337,2693,53030,0.35,0.067
91,HKG,208930,569031,777961,5.17,0.987
92,HND,6791,708,7499,0.05,0.010
93,HRV,113886,93517,207403,1.38,0.263
94,HTI,2010,0,2010,0.01,0.003
95,HUN,204224,192491,396715,2.64,0.503
96,IDN,877141,144289,1021430,6.79,1.295
97,IND,219809,99134,318943,2.12,0.405
98,IRL,41688,24551,66239,0.44,0.084
99,IRN,3195,1184,4379,0.03,0.006
100,IRQ,201600,0,201600,1.34,0.256
101,ISL,16689,8001,24690,0.16,0.031
102,ISR,39754,557420,597174,3.97,0.757
103,ITA,736314,1005693,1742007,11.59,2.209
104,JAM,3879,2000,5879,0.04,0.007
105,JOR,37393,424517,461910,3.07,0.586
106,JPN,841023,525905,1366928,9.09,1.734
107,KAZ,7819,8547,16366,0.11,0.021
108,KEN,6561,501,7062,0.05,0.009
109,KGZ,578,899,1477,0.01,0.002
110,KHM,184637,13213,197850,1.32,0.251
111,KIR,348,161,509,0.00,0.001
112,KNA,423,237,660,0.00,0.001
113,KOR,249455,336358,585813,3.90,0.743
114,KWT,37051,0,37051,0.25,0.047
115,LAO,1416641,0,1416641,9.42,1.797
116,LBN,23058,128025,151083,1.00,0.192
117,LBR,3564,0,3564,0.02,0.005
118,LBY,4106,1482,5588,0.04,0.007
119,LCA,695,0,695,0.00,0.001
120,LKA,79359,5974,85333,0.57,0.108
121,LSO,2222,102,2324,0.02,0.003
122,LTU,136766,251772,388538,2.58,0.493
123,LUX,3597,32130,35727,0.24,0.045
124,LVA,230707,344165,574872,3.82,0.729
125,MAC,4032,3540,7572,0.05,0.010
126,MAR,25809,20038,45847,0.30,0.058
127,MDA,4420,3652,8072,0.05,0.010
128,MDG,6722,378,7100,0.05,0.009
129,MDV,25631,59940,85571,0.57,0.109
130,MEX,264923,340261,605184,4.03,0.768
131,MHL,5,0,5,0.00,0.000
132,MKD,6670,5964,12634,0.08,0.016
133,MLI,323,13060,13383,0.09,0.017
134,MLT,4669,7149,11818,0.08,0.015
135,MMR,80089,2564,82653,0.55,0.105
136,MNE,1676,595,2271,0.02,0.003
137,MNG,312,247,559,0.00,0.001
138,MNP,6,0,6,0.00,0.000
139,MOZ,278513,71200,349713,2.33,0.444
140,MRT,1497,866,2363,0.02,0.003
141,MSR,2,47,49,0.00,0.000
142,MUS,17340,12847,30187,0.20,0.038
143,MWI,6770,23339,30109,0.20,0.038
144,MYS,2121045,2412289,4533334,30.15,5.749
145,MYT,1758,196,1954,0.01,0.002
146,NA,348475,484949,833424,5.54,1.057
147,NAM,16986,25269,42255,0.28,0.054
148,NCL,3523,4770,8293,0.06,0.011
149,NER,27,17485,17512,0.12,0.022
150,NFK,33,0,33,0.00,0.000
151,NGA,14039,1250,15289,0.10,0.019
152,NIC,15945,25861,41806,0.28,0.053
153,NIU,35,0,35,0.00,0.000
154,NLD,423833,400349,824182,5.48,1.045
155,NOR,86892,57096,143988,0.96,0.183
156,NPL,151,201,352,0.00,0.000
157,NRU,147,0,147,0.00,0.000
158,NZL,220182,41930,262112,1.74,0.332
159,OMN,50624,59590,110214,0.73,0.140
160,PAK,26324,57483,83807,0.56,0.106
161,PAN,13456,4252,17708,0.12,0.022
162,PER,318375,167076,485451,3.23,0.616
163,PHL,487746,459454,947200,6.30,1.201
164,PLW,10,522,532,0.00,0.001
165,PNG,27307,6548,33855,0.23,0.043
166,POL,144961,133219,278180,1.85,0.353
167,PRK,1146,0,1146,0.01,0.001
168,PRT,79204,124514,203718,1.35,0.258
169,PRY,70684,62034,132718,0.88,0.168
170,PSE,43,5128,5171,0.03,0.007
171,PYF,1186,1599,2785,0.02,0.004
172,QAT,22745,6878,29623,0.20,0.038
173,ROU,478977,77915,556892,3.70,0.706
174,RUS,957910,305769,1263679,8.41,1.603
175,RWA,181,516,697,0.00,0.001
176,SAU,103470,677632,781102,5.20,0.991
177,SDN,2371,152814,155185,1.03,0.197
178,SEN,21359,6635,27994,0.19,0.036
179,SGP,206799,116556,323355,2.15,0.410
180,SHN,33,0,33,0.00,0.000
181,SLB,21699,0,21699,0.14,0.028
182,SLE,3350,0,3350,0.02,0.004
183,SLV,1500,1455,2955,0.02,0.004
184,SMR,260,0,260,0.00,0.000
185,SOM,80,0,80,0.00,0.000
186,SPM,51,0,51,0.00,0.000
187,SRB,115838,57684,173522,1.15,0.220
188,SSD,0,0,0,0.00,0.000
189,STP,0,2,2,0.00,0.000
190,SUR,45623,3814,49437,0.33,0.063
191,SVK,60073,80642,140715,0.94,0.178
192,SVN,78535,68411,146946,0.98,0.186
193,SWE,730935,56048,786983,5.23,0.998
194,SWZ,2740,0,2740,0.02,0.003
195,SXM,42,0,42,0.00,0.000
196,SYC,3041,0,3041,0.02,0.004
197,SYR,10128,101945,112073,0.75,0.142
198,TCA,275,260,535,0.00,0.001
199,TCD,293,0,293,0.00,0.000
200,TGO,9340,3474,12814,0.09,0.016
201,THA,3431472,4230867,7662339,50.96,9.718
202,TJK,2218,0,2218,0.01,0.003
203,TKM,808,0,808,0.01,0.001
204,TLS,716,0,716,0.00,0.001
205,TON,900,1053,1953,0.01,0.002
206,TTO,528,352,880,0.01,0.001
207,TUN,23140,51503,74643,0.50,0.095
208,TUR,67597,41418,109015,0.73,0.138
209,TUV,373,0,373,0.00,0.000
210,TZA,50540,21696,72236,0.48,0.092
211,UGA,432,326,758,0.01,0.001
212,UKR,104793,58544,163337,1.09,0.207
213,UMI,51,0,51,0.00,0.000
214,URY,164118,162803,326921,2.17,0.415
215,USA,4550636,3267631,7818267,52.00,9.916
216,UZB,7478,0,7478,0.05,0.009
217,VAT,27,0,27,0.00,0.000
218,VCT,254,105,359,0.00,0.000
219,VEN,15401,11458,26859,0.18,0.034
220,VGB,460,0,460,0.00,0.001
221,VNM,968068,2739964,3708032,24.66,4.703
222,VUT,697,568,1265,0.01,0.002
223,WLF,76,0,76,0.00,0.000
224,WSM,199,1684,1883,0.01,0.002
225,YEM,139692,266834,406526,2.70,0.516
226,ZAF,185929,119436,305365,2.03,0.387
227,ZMB,12196,29792,41988,0.28,0.053
228,ZWE,3585,1326,4911,0.03,0.006
